[{
    "_title": "sample",
    "_map": [
        "0000f0000f000f000",
        "00000000000000000",
        "0000ff000f00f0000",
        "00000000000000000",
        "00000000000000000",
        "f0000000f000f0000",
        "00000000000000000",
        "0000f000f000f0000",
        "00000000000000000",
        "0000f000f000f0000",
        "00000000000000000",
        "000f000f0000f0000",
        "00000000000000000",
        "00000z00000000000",
        "000f00000000f0000",
        "00000000000000000",
        "00000000000000000",
        "0000000f0000f0000",
        "00000000000000000",
        "0000f000000000000",
        "00000000000000000",
        "000000000000f0000",
        "00000000000000000",
        "00000000000000000",
        "000aaa00000aaa000",
        "00aaaaa000aaaaa00",
        "00000000000000000",
        "00000e00000000000",
        "00000e00000000000",
        "00000e00000000000",
        "00000000000000000",
        "00000000000000000",
        "00000000000000000",
        "00000000000000000",
        "000aaa00000aaa000",
        "00000000000000000",
        "0000000b00000b000",
        "0000b00000b000000",
        "0000000d00000d000",
        "0000d00000d000000",
        "00000000000000000",
        "00000000000000000",
        "000aaa00000aaa000",
        "00000000000c00000",
        "00000000000g00000",
        "00000aaa000c00000",
        "00000000000g00000",
        "00000aaa000c00000",
        "00000000000g00000",
        "00000000000c00000",
        "00000000000000000",
        "00000000000000000",
        "00000c00000000000",
        "00000g000f00f0000",
        "00000c00000000000",
        "00000g000f00f0000",
        "00000000000000000",
        "00000b00b00b00000",
        "00000000000000000",
        "0000d000d000d0000",
        "0000f000000000000",
        "00000e00000000000",
        "0000d000d000d0000",
        "0000aaa0aaa0aaa00",
        "00000000000000000",
        "0000aaa0aaa0aaa00",
        "00000000000000000",
        "00000000000000000",
        "00000000000000000",
        "00000000000000000",
        "00000000000000000",
        "0000f0000f000f000",
        "00000000000000000",
        "0000ff000f00f0000",
        "00000000000000000",
        "00000000000000000",
        "f0000000f000f0000",
        "00000000000000000",
        "0000f000f000f0000",
        "00000000000000000",
        "0000f000f000f0000",
        "00000000000000000",
        "000f000f0000f0000",
        "00000000000000000",
        "00000z00000000000",
        "000f00000000f0000",
        "00000000000000000",
        "00000000000000000",
        "0000000f0000f0000",
        "00000000000000000",
        "0000f000000000000",
        "00000000000000000",
        "000000000000f0000",
        "00000000000000000",
        "00000000000000000",
        "000aaa00000aaa000",
        "00aaaaa000aaaaa00",
        "00000000000000000",
        "00000e00000000000",
        "00000000000000000",
        "00000000000000000",
        "00000e00000000000",
        "00000000000000000",
        "00000000000000000",
        "00000e00000000000",
        "00000000000000000",
        "000d00000d0h00h00",
        "000000d0000000000",
        "00000000000000000",
        "000aaa00000aaa000",
        "00000000000000000",
        "00000000000000000",
        "0000b00b00b00b000",
        "00000000000000000",
        "00000000000000000",
        "0000000d00000d000",
        "0000d00000d000000",
        "00000000000000000",
        "00000000000000000",
        "000aaa00000aaa000",
        "00000000000000000",
        "00000000000000000",
        "00000000000000000",
        "00000000000g00000",
        "00000000000000000",
        "00000000000000000",
        "00000000000c00000",
        "00000000000000000",
        "00000000000000000",
        "00000aaa000g00000",
        "00000000000000000",
        "00000000000000000",
        "000i0000000c00000",
        "00000000000000000",
        "00000aaa000c00i00",
        "00000000000000000",
        "000i000i000g00000",
        "00000000000000000",
        "00h00h00000c00000",
        "0000000i0000000ii",
        "ii000000000000000",
        "00000c000i000i000",
        "00000g000f00f0000",
        "00000c00000000000",
        "00000g000f00f0000",
        "00000000000000000",
        "00000b00000b00000",
        "00000000b00000000",
        "0000d000d000d0000",
        "0000f000d00000000",
        "00000e00000000000",
        "0000d0000000d0000",
        "0000aaa0aaa0aaa00",
        "00000000000000000",
        "0000aaa0aaa0aaa00",
        "0000f0000f000f000",
        "00000000000000000",
        "0000ff000f00f0000",
        "00000000000000000",
        "0000j0000000j0000",
        "f0000000f000f0000",
        "00000000000000000",
        "0000f000f000f0000",
        "00000000000000000",
        "0000f000f000f0000",
        "00000000000000000",
        "000f000f0000f0000",
        "00000000000000000",
        "00000z00000000000",
        "000f00000000f0000",
        "00000000000000000",
        "00000000000000000",
        "0000000f0000f0000",
        "00000000000000000",
        "0000f000000000000",
        "00000000000000000",
        "000000000000f0000",
        "00000000000000000",
        "00000000000000000",
        "000aaa00000aaa000",
        "00aaaaa000aaaaa00",
        "00000000000000000",
        "00000e00000000000",
        "00000e00000j00000",
        "00i00e00000000000",
        "00000000000000000",
        "0000y0000000i0000",
        "0000i000000000000",
        "000000000i0000000",
        "000aaa00000aaa000",
        "000000i0000000000",
        "0000000b00000b000",
        "0000b00000b00i000",
        "0000000d00000d000",
        "0000d00000d000000",
        "000000i0000000000",
        "00000000000000000",
        "000aaa00000aaa000",
        "00000000000c00000",
        "00000000000g00000",
        "00000aaa000c00000",
        "00000000000g00000",
        "00000aaa000c00000",
        "00000000000g00000",
        "00000000000c00000",
        "00000y00000y00000",
        "00000000000000j00",
        "00000c00000000000",
        "00000g000f00f0000",
        "00000c00000000000",
        "00000g000f00f0000",
        "00000000000000000",
        "000000j0000000000",
        "00000000000000000",
        "00000000000000000",
        "0000d000d000d0000",
        "00000000000000000",
        "00000000000000000",
        "0000f000000000000",
        "00000e00000000000",
        "00000000000000000",
        "00000000000000000",
        "0000d000d000d0000",
        "00000000000000000",
        "00000000000000000",
        "00000000000000000",
        "0000aaa0aaa0aaa00",
        "00000000000000000",
        "0000aaa0aaa0aaa00",
        "00000000000000000",
        "00000000000000000",
        "000000y0000000000",
        "00000000000000000",
        "00000000000000000",
        "0000f0000f000f000",
        "00000000000000000",
        "0000ff000f00f0000",
        "00000000000000000",
        "00000000000000000",
        "f0000000f000f0000",
        "00000000000000000",
        "0000f000f000f0000",
        "00000000000000000",
        "0000f000f000f0000",
        "00000000000000000",
        "000f000f0000f0000",
        "00000000000000000",
        "00000z00000000000",
        "000f00000000f0000",
        "00000000000000000",
        "00000000000000000",
        "0000000f0000f0000",
        "00000000000000000",
        "0000f000000000000",
        "00000000000000000",
        "000000000000f0000",
        "00000000000000000",
        "00000000000000000",
        "000aaa00000aaa000",
        "00aaaaa000aaaaa00",
        "00000000000000000",
        "00000e00000000000",
        "00000e00000y00000",
        "00000e00y00000000",
        "00000y00000000000",
        "00yd00000d0h00h00",
        "000000d0000000000",
        "000000000000j0000",
        "000aaa00000aaa000",
        "00000000000000000",
        "00000000j00000000",
        "00000000000000000",
        "0000000d00000d000",
        "0000d00000d000000",
        "00000000000000000",
        "00000000000000000",
        "000aaa00000aaa000",
        "00000000000g00000",
        "00000000000000000",
        "00000000000c00000",
        "00000000000000000",
        "00000aaa000g00000",
        "00000000000000000",
        "00000000000c00000",
        "00000aaa000c00000",
        "00000000000000000",
        "00000000000g00000",
        "00h00h00000c00000",
        "00000000000000000",
        "00000i00y000i0000",
        "00000c00000000000",
        "00000000000000000",
        "00000000000000000",
        "00000000000000000",
        "00000g000f00f0000",
        "00000c00y00000000",
        "00000000000000000",
        "00000000000000000",
        "00000000000000000",
        "00000g000f00f0000",
        "00000000000000000",
        "00000000y00000000",
        "00000000000000000",
        "0000d000d000d0000",
        "00000000000000000",
        "00000000000000000",
        "0000f000d00000000",
        "00000e00000000000",
        "00000000000000000",
        "0000aaa0aaa0aaa00",
        "00000000000000000",
        "0000aaa0aaa0aaa00",
        "00000000000000000",
        "00000000000000000",
        "00000000000000000",
        "00000000000000000",
        "00000000000000000",
        "00000y00000000000"

    ],
    "_difficult": "3"
}]