[
{"_title":"sample","_eid":"5","_map":[
"00000000000000000",
"00000000000000000",
"00000000000000000",
"00000000000000000",
"00000000000000000",
"00000000000000000",
"00000000000000000",
"00000000000000000",
"000aaa00000aaa000",
"00000000000000000",
"00000000000000000",
"0000b00b00b00b000",
"00000000000000000",
"00000000000000000",
"00000000000000000",
"00000000000000000",
"000aaa00000aaa000",
"00000000000c00000",
"00000000000c00000",
"00000000000c00000",
"00000000000c00000",
"00000000000c00000",
"00000000000c00000",
"00000000000c00000",
"00000000000000000",
"00000000000000000",
"00000c00000000000",
"00000c00000000000",
"00000c00000000000",
"00000c00000000000",
"00000000000000000",
"00000b00b00b00000",
"00000000000000000",
"0000d000d000d0000",
"00000000000000000",
"00000000000000000",
"0000d000d000d0000",
"0000aaa0aaa0aaa00",
"00000000000000000",
"0000aaa0aaa0aaa00"

],"_theme":"_THEME2","_body":"最初からパワーカプセルを沢山取得して最強装備に近づけて進めるのがカギ。","_initx":"975","_bgmusic":"type2","_boss":"enemy_death","_speed":"1","_difficult":"3","_map_infinite":"false"}
]